15
###############
#...#...#.....#
#.###.#######.#
#...#.#.#..G#.#
#.###.#.#.###.#
#...#.#...#...#
#.###.#.###.###
#.#.#.....#...#
#.#.#.#####.###
#...#.#.......#
###.#.#.#.#.###
#...#...#.#...#
#.###.#.###.#.#
#S....#.#...#.#
###############
